█████████████████████
█O      █ █ █   █   █
███ █████ █ █ ███ █ █
█   █ █   █   █   █ █
███ █ █ █ ███ ███ ███
█   █   █           █
███ █ ███ ███████ ███
█ █   █   █ █   █   █
█ ███ █ ███ █ ███████
█     █ █           █
███████ █ █ █ █████ █
█     █   █ █   █   █
█ ███ █ █ ███████████
█   █   █     █     █
███ ███████ ███ ███ █
█       █   █     █ █
█ ███████████ █████ █
█     █   █   █ █ █ █
█ ███ ███ █ █ █ █ ███
█ █         █      X█
█████████████████████
