███████████████████████████████████████████████████
█O  █ █                       █     █ █     █     █
█ ███ █ ███████ ███ ███ █████ █████ █ █ ███████ █ █
█           █   █   █       █   █       █       █ █
█ █ █ ███████ █████ █████████ ███ ███████████ █████
█ █ █     █       █   █   █   █     █           █ █
█ █████ █████████████████ █ █ █ █ █ █ █████████ █ █
█ █ █ █       █     █ █   █ █   █ █ █ █   █ █     █
█ █ █ █████ ███ ███ █ █ ███ ███ █████ █ █ █ ███ ███
█ █ █ █       █   █     █ █ █ █ █     █ █   █ █   █
█ █ █ ███████ █████ ███ █ █ █ █ █ ███ ███ ███ ███ █
█ █   █       █ █ █   █       █     █     █   █   █
███ █████ █████ █ █████ █████ █ █████ █ ███ ███ █ █
█   █ █     █   █       █     █ █   █ █ █ █ █   █ █
█ █ █ ███ ███ █████ ███ ███████ █ █ █ ███ █ ███████
█ █ █       █   █     █       █   █ █   █ █       █
█ █████████ ███ ███ █ █ ███ █ ███████ ███ █ ███ ███
█ █   █   █ █     █ █ █   █ █ █     █ █ █     █   █
█ █ █ ███ █████ █████████ ███ █████ ███ ███ ███ ███
█ █ █ █ █           █ █     █ █       █     █     █
█ ███ █ ███ ███ █ ███ █████ ███ █████████ █████ ███
█   █ █     █   █   █         █ █ █       █ █ █   █
█ █ █ █ █ █ █ ███████ ███ ███ █ █ █ █ █ ███ █ █████
█ █ █   █ █ █   █       █ █     █   █ █     █ █ █ █
█ █ ███████████ █ █ █ ███ ███ █████ █ █ █████ █ █ █
█ █ █ █     █     █ █   █   █ █     █ █ █         █
███ █ █ ███ █ ███████ █████ █ ███████ ███ ███████ █
█     █   █ █   █ █     █ █ █   █   █         █   █
█ █ █████ █ ███ █ █ █████ █ ███ █ ███ █ ███ █████ █
█ █       █     █ █ █   █ █   █ █ █ █ █   █   █   █
███ ███ █████ ███ █ ███ █ █ █ ███ █ █████ ███████ █
█ █ █ █ █       █ █ █       █ █   █     █     █   █
█ ███ █ █████ ███ █ ███ ███ █████ █ █ █ █ ███████ █
█ █ █   █   █   █   █ █ █     █   █ █ █   █ █   █ █
█ █ █ █████ █ ███████ █ ███ █ ███ █ █ ███ █ █ █ █ █
█   █ █     █     █     █ █ █   █   █   █   █ █   █
███ ███████ █ ███████████ █ █ ███ ███ █████ ███ ███
█     █ █       █   █ █ █ █ █ █ █   █ █   █ █     █
█ ███ █ ███ █████ █ █ █ █ ███ █ █ ███████ ███ █████
█ █     █   █   █ █ █ █     █ █ █ █         █     █
█ ███ █ ███ ███ ███ █ █████ █ █ █ █████████ █ ███ █
█   █ █       █ █                 █             █ █
█████ █ █ █████ █ █ ███ █████ █ ███ █ ███ ███ ███ █
█ █   █ █ █ █ █   █ █   █     █   █ █   █   █   █ █
█ ███ ███ █ █ ███ ███ ███ ███ █████████ ███ ███ █ █
█     █ █     █   █     █ █         █ █ █   █ █ █ █
█ █████ ███ █████ █████ █ ███████ ███ ███ ███ █████
█   █   █     █   █ █   █   █ █   █     █     █   █
█ █ ███ █ ███ █████ █ █ █ ███ █ █████ █ █ █ █ █ █ █
█ █ █       █ █       █ █ █           █ █ █ █   █X█
███████████████████████████████████████████████████
