███████████
█O  █     █
█ ███████ █
█ █   █   █
█ █ █████ █
█   █   █ █
█ ███ ███ █
█   █ █   █
█ █ █ ███ █
█ █      X█
███████████
