███████████
█O  █     █
█ ███████ █
█ █   █   █
█ ███ █ ███
█     █ █ █
█ █████ █ █
█   █     █
███ █████ █
█   █     █
███ █ █ ███
█ █   █   █
█ █ ███████
█ █     █ █
█ █ ███ █ █
█     █   █
█ ███ ███ █
█ █     █ █
███ █ █████
█ █ █ █   █
█ ███ █ ███
█ █       █
█ █ ███████
█   █     █
█ █ █ █████
█ █     █ █
█████ ███ █
█ █   █ █ █
█ █ ███ █ █
█     █   █
█ ███ █ █ █
█ █   █ █ █
█ ███████ █
█ █   █ █ █
█ ███ █ █ █
█     █   █
███ ███ █ █
█   █   █ █
█ █ ███ ███
█ █     █ █
█ ███ █ █ █
█ █   █ █ █
███████ █ █
█   █ █ █ █
███ █ █ █ █
█   █   █ █
███ █ █ █ █
█     █   █
█ ███████ █
█   █     █
███ ███ ███
█   █ █   █
█ █ █ ███ █
█ █   █   █
█ █████ ███
█     █   █
█ ███ █████
█ █       █
█████████ █
█ █       █
█ █ ███████
█     █   █
███ █████ █
█       █ █
█ ███ █ █ █
█   █ █   █
█ █ █ █████
█ █ █ █ █ █
█ ███ █ █ █
█   █     █
█ ███ ███ █
█ █     █ █
█ ███████ █
█   █     █
█ █████████
█         █
█ █████████
█       █ █
█ █ █ █ █ █
█ █ █ █   █
███ █████ █
█     █ █ █
█ █ ███ █ █
█ █ █   █ █
█ ███ █████
█ █   █   █
█ █ █ █ ███
█   █     █
█████████ █
█       █ █
█ █ █ █ █ █
█ █ █ █   █
█████ ███ █
█     █   █
█████ █ █ █
█     █ █ █
█████████ █
█         █
███ █ ███ █
█   █ █  X█
███████████
