█████████████████████████████████████████████████████████████████████████████████████████████████████
█O    █   █     █   █         █     █   █   █   █ █               █           █ █ █ █     █   █   █ █
███ █████ █ ███ █ █ ███ █████ ███ █ ███ █ ███ █ █ ███ ███ ███ █ ███ ███ █ █ ███ █ █ █ ███ █ █ █ ███ █
█       █   █   █ █         █ █ █ █ █     █   █   █   █     █ █     █ █ █ █ █   █       █ █ █     █ █
█ ███ ███████ █ █ █████████ ███ ███ ███ █ █ █████ ███████████ ███ █ █ ███ █ █ █████ █████ ███ █ █ █ █
█ █ █ █ █   █ █   █   █     █     █ █   █ █ █ █   █       █ █ █   █     █ █         █ █     █ █ █   █
███ █ █ ███ █ █████ █ ███ █████ ███ █ █ █ █ █ █ █████ █████ █ █ █ ███████ ███████ █ █ █████ ███████ █
█     █   █     █ █ █ █               █ █   █       █       █ █ █ █     █   █     █   █     █ █     █
███ █ █ ███ █ ███ ███ ███████ █████████ █████ █████████ █ ███ █ ███ █ █ █ █████ ███ ███ ███ █ ███ █ █
█   █       █       █             █       █             █     █     █ █ █ █       █ █   █         █X█
█████████████████████████████████████████████████████████████████████████████████████████████████████
