█████████████████████████████████████████████████████████████████████████████████████████████████████
█O█                   █ █   █   █ █   █     █         █           █   █     █       █       █   █   █
█ █████ ███████ ███ █ █ ███ █ ███ ███ █████ █████ ███ █ ███ █ ███████ ███ ███ ███ █████████ ███ █ ███
█   █   █ █     █ █ █ █   █         █           █   █     █ █     █   █     █ █   █ █   █       █   █
█ ███████ █████ █ ███ █ █ ███ ███████ █ ███████ █ █████████ █████ ███ ███ ███████ █ █ █████ █ █ █ ███
█   █ █   █         █   █ █   █ █     █ █ █     █   █   █   █       █ █       █             █ █     █
█ █ █ █ ███ █████████████ █ ███ █████ ███ █ █ █████ █ █████████ ███ █ ███ █████ █████ █ █████████ ███
█ █     █ █ █   █ █   █ █     █       █     █     █   █     █   █   █       █       █ █ █ █         █
█ █ ███ █ █ █ █ █ █ ███ ███ ███ ███████ ███ █████ █████ ███████ ███ █ █████ █████ ███████ █ █ █████ █
█ █   █       █   █ █ █ █   █ █ █ █       █ █   █         █   █ █ █ █ █   █ █   █     █ █ █ █ █ █   █
█ ███ █████ ███ █ █ █ █ █ ███ ███ █ █ █ █████ ███ ███ ███████ ███ █ █ ███ █ █ ███ █████ █ █ ███ ███ █
█ █ █ █   █ █ █ █     █ █ █ █ █ █ █ █ █     █       █   █   █       █ █ █ █       █         █       █
█ █ █████ █ █ ███████ █ ███ █ █ █ █████ █ █ ███████████ █ █ █ █████ █ █ █ ███ ███ ███████ █ ███ ███ █
█   █ █     █               █       █   █ █ █ █   █     █ █ █ █ █ █       █ █   █     █   █ █ █ █   █
█████ ███ ███████████ ███████ ███ ███ █ █ █ █ ███ █ ███ █ █████ █ ███ █████ ███████ █████ █ █ █ ███ █
█   █ █ █ █ █       █       █   █   █ █ █ █ █ █ █ █ █ █ █ █         █ █   █   █   █ █     █ █     █ █
█ █ █ █ █ █ ███████ █ ███ ███ ███ ███ ███████ █ █ █ █ ███ █ █ █████ █ █ █ █ █ ███ ███ ███ █ █████████
█ █     █       █ █ █   █   █ █     █ █   █ █     █   █   █ █ █ █ █ █ █ █   █ █ █     █ █ █     █   █
█ ███ ███ ███████ █ ███████████ █████████ █ █ ███ █ █████ ███ █ █ █████████ █ █ █ ███ █ █ ███ ███ ███
█   █   █ █     █     █ █   █         █ █   █   █           █ █   █ █       █ █ █   █ █     █       █
███ ███ █ █ █ ███ ███ █ █ █ ███ ███ ███ █ ███ ███ █ █████ ███ ███ █ █████████ █ █ █████ ███ ███ █ ███
█     █     █ █ █   █     █ █   █               █ █     █     █   █ █ █ █   █       █   █ █ █ █ █   █
█ █████ ███ ███ ███ ███ ███ █ ███ █ █ ███ █████ █████████ █ █ █ ███ █ █ ███ █ ███████████ █ █ █████ █
█     █ █       █   █   █ █   █ █ █ █ █ █ █   █       █ █ █ █ █     █   █       █ █       █       █ █
███ ███ █████████████ ███ █ █ █ ███ ███ ███ ███████████ ███████████ █ █ █████ ███ ███ █ █ █████████ █
█   █   █ █   █   █     █ █ █   █ █     █ █     █         █         █ █ █           █ █ █ █ █       █
█████ ███ ███ ███ █████ █ ███ ███ ███████ ███ █ █ █████ █████ █ █ █ █ █ ███ ███ █████████ █ █ █ ███ █
█       █     █           █   █     █ █     █ █   █       █   █ █ █   █ █ █ █ █     █   █     █ █   █
█ █ █ █ ███ █ █ ███ █████ ███████ ███ █████ █████ █ █ █████ █████ ███████ █ █ ███ ███ █ █ █████ █████
█ █ █ █ █   █ █   █   █   █       █         █   █ █ █     █   █   █ █ █     █ █ █   █ █     █       █
█ █ ███ █ ███ █ █████ █ ███ ███████ ███████████ █ █████ █ █████ ███ █ █ █ ███ █ ███████████ █ █████ █
█ █ █ █     █ █ █ █   █     █ █         █     █     █   █   █         █ █ █       █     █   █ █ █   █
█ █ █ █ ███████ █ ███ █████ █ █ █████ ███████ ███ ███ █████ █ ███ ███████ █ █████████ █████ ███ █ ███
█ █ █     █ █ █ █   █ █         █       █ █ █     █ █ █ █     █             █ █         █   █   █   █
█████ ███ █ █ █ █ █████ ███████ █████████ █ █ █████ █ █ █ ███ ███ █████████ █ ███████ ███ ███ █ ███ █
█   █ █   █ █ █   █   █ █             █   █ █     █     █   █ █ █ █   █           █     █     █ █   █
█ ███ █████ █ █ █ █ █████ ███ █████ █████ █ █ ███ █████████ ███ ███ ███ █ ███████ ███ ███ ███████ ███
█ █   █       █ █ █ █ █   █       █ █         █   █     █   █         █ █ █ █ █ █ █ █ █ █       █ █ █
█ █ █████████ ███ █ █ ███████████ ███████ █████ ███████ ███ ███ ███ ███ ███ █ █ █ █ █ █ █████████ █ █
█     █   █     █   █     █   █ █     █       █ █ █ █   █   █   █     █ █     █   █     █ █     █   █
█████ ███ █ █ █ █ █ █████ █ ███ ███ █ █ █████ █ █ █ █ ███ █████ █████ █ █ ███ ███ ███ █ █ █ ███ ███ █
█ █         █ █ █ █   █   █   █     █ █     █ █ █     █   █   █   █   █   █ █   █   █ █       █   █ █
█ █ ███ █ ███████ ███ █ ███ █████ ███████ ███ █████ █████ ███ █ █ █ ███████ ███████ █ ███ █ █ █ █████
█ █ █   █     █   █         █ █     █   █ █   █   █ █ █         █ █   █     █     █   █   █ █ █     █
█ █ █████████ █ ███ █████ █ █ █████ █ ███ ███ ███ █ █ █ ███████████████████ █ ███ ███████ ███ ███ ███
█   █ █     █ █   █   █ █ █     █     █ █ █ █   █       █     █ █   █   █     █     █   █ █   █     █
█ █ █ █████ █ █ █ ███ █ █ █ █ ███ █████ █ █ █████ █ █████ █ ███ ███ ███ █ █████████ ███ █ ███████████
█ █     █ █     █   █ █   █ █ █   █         █     █       █ █ █ █     █ █ █   █   █ █     █     █   █
█ ███ ███ █ ███ ███ █ ███████████ ███ █ █████ █ █ ███ █ █ ███ █ █ ███ █ ███ █████ █ ███ █ ███ ███ █ █
█ █ █ █     █     █ █ █     █     █ █ █     █ █ █   █ █ █ █     █   █ █ █         █     █ █       █ █
███ █████ ███ █ ███████ ███ ███ ███ █████ █████████ █ █ █ █████ █ █ █ █ █ ███████ █████ █████ ███████
█         █   █ █   █ █ █   █   █ █ █       █   █ █ █ █ █ █     █ █ █ █   █ █         █ █ █     █   █
███ ███ █ ███ █████ █ █ █ █ ███ █ █ █████████ █ █ █ █ █████ ███ █ █ ███████ █ █ █ █████ █ █ █████ ███
█   █   █ █ █   █     █ █ █     █   █     █ █ █ █   █         █   █     █   █ █ █     █   █   █ █ █ █
███████ ███ ███ █ ███ █████ █ █████ █ █████ █ ███ █████ ███████████ ███████ █████ █ █████ █ ███ █ █ █
█ █   █   █     █ █         █ █           █     █   █   █   █   █       █ █   █ █ █         █   █   █
█ ███ █ █ ███████████████████████ ███████ █ ███████ ███ █ █████ █████ ███ █ ███ ███████ ███ ███ ███ █
█       █             █ █         █ █   █   █ █     █     █     █ █             █         █ █ █ █ █ █
█████ ███ █ █ ███ █ █ █ █ ███ █ ███ █ ███ ███ ███████████ █ █████ █ █ ███ ███████ █ ███ █████ █ █ █ █
█   █ █   █ █   █ █ █ █   █ █ █         █     █   █     █         █ █ █ █       █ █ █ █       █ █   █
█ ███ ███ ███████████ █████ █ █ ███ █ ███ █████ █ █ ███ ███ █ ███ █████ ███████████ █ █████ ███ ███ █
█   █ █   █   █   █   █     █ █ █ █ █   █ █     █   █   █   █ █         █ █     █   █     █   █ █   █
███ █████ █ ███ █ ███ █ █████ █ █ █ █ █ █ ███ █████ ███████ █ █ █ ███████ ███ █ ███ █ █ █████ █ █ █ █
█             █ █   █       █ █   █ █ █ █     █       █ █   █ █ █ █   █     █ █   █   █ █   █     █ █
█ █████████ █████ █████████████ █████████ █ █ █████████ ███ ███████ █ █████ █ ███ █ █████ █████ ███ █
█   █       █ █     █ █         █     █   █ █       █ █ █   █     █ █ █     █ █       █     █ █   █ █
███ ███ █████ █ ███ █ ███ █ ███ █ ███████████ ███ ███ █ █████ █████ █ ███ ███ █████████ █ █ █ █████ █
█   █ █           █ █     █ █ █     █   █   █ █ █ █               █ █       █ █   █   █ █ █ █       █
███ █ █ █ █ █ █████ ███ ███ █ █████ █ █████ █ █ █ ███ ███ █████ █████ █████ ███ █ ███ ███ █████████ █
█     █ █ █ █ █ █ █     █ █ █         █     █   █   █   █ █ █   █     █     █   █   █ █     █       █
███████ █ █ █ █ █ ███████ ███ ███████ ███ █████████ ███ ███ ███ █ ███ █████ █ █ █████ █ █████ █ ███ █
█       █ █ █ █ █ █ █ █ █   █ █ █   █     █   █     █     █ █   █ █     █ █ █ █ █   █         █   █ █
█ ███████████ █ █ █ █ █ ███ ███ █ █ █ █ █████ █ █ █████ █ █ █ █ ███ █████ █████ █ █████ █ █████████ █
█     █   █ █ █   █         █   █ █   █ █ █   █ █       █ █ █ █   █       █   █   █   █ █ █   █ █ █ █
█ ███ █ █ █ █ ███ █ ███████ ███ █ ███ █ █ █ █ ███ █ █████ █ ███ ███ ███ █ █ █ █ █ ███ ███ █ █ █ █ █ █
█   █   █   █     █ █ █     █   █   █ █   █ █     █   █       █ █     █ █ █ █ █ █ █   █   █ █       █
███ ███ ███████ █ █ █ ███ █████ ███████ █ ███████ █ █████████ █████ ███ █ ███ ███ █ █ ███ █ █████ ███
█   █   █   █   █ █     █ █       █ █ █ █   █ █   █     █ █   █   █ █   █   █ █     █     █ █   █   █
█ █ █ ███ ███ ███ █ █████ ███ █████ █ █ █████ ███ █████ █ █ █ ███ █████ █ ███ █ █ ███ ███ ███ ███ ███
█ █ █   █     █   █   █               █   █     █   █     █ █   █ █   █ █       █   █ █     █       █
█████ █████ █████ ███ ███ ███ ███████ █████ █ █ ███ █ █ █ █ █████ █ █ █ █ █ █ █ ███ ███████ ███████ █
█ █ █   █ █ █         █   █   █     █ █     █ █ █ █ █ █ █ █   █     █   █ █ █ █ █ █   █   █     █   █
█ █ █████ █ ███ ███ █████ █ █ █ ███████████ █ █ █ ███ █ █████████ █████████ █████ ███ ███ ███████ █ █
█ █   █ █   █     █ █     █ █       █       █ █   █ █ █             █   █         █     █   █     █ █
█ █ ███ █████ █ ███ ███████ ███ ███████ ███ █████ █ █ █ ███ ███ █████ ███ ███ █████ ███ ███ █████ ███
█     █ █ █   █   █ █ █     █           █ █     █ █   █ █   █ █ █   █ █     █ █   █ █   █ █       █ █
███ ███ █ ███ ███ █ █ █ ███████████████ █ ███ █████████████ █ █ █ ███ ███████████ ███ ███ ███ █ █ █ █
█ █       █     █ █ █ █ █   █         █ █   █   █   █     █   █ █     █   █ █           █ █ █ █ █   █
█ █████ █ █████████ █ █ █ █ ███ ███████ ███ █████ █ █ ███ █ █ █████ ███ ███ █ ███ █ ███ █ █ █ ███ █ █
█     █ █ █ █       █ █   █       █   █ █     █   █   █     █         █ █ █     █ █ █     █     █ █ █
█ █ █████ █ ███ ███ █ █████ ███ █ ███ ███████ █ █ ███████ ███ ███ ███ █ █ █████ █████ █ █ █████ █ ███
█ █       █   █   █ █   █     █ █     █       █ █   █ █ █ █ █ █   █ █   █   █   █ █ █ █ █   █   █   █
█ █ ███ █ ███ █ ███ █ █ ███ █ ███ ███ ███ ███ ███ ███ █ █ █ █ ███ █ █ ███ ███████ █ █████████ █ █████
█ █ █   █ █ █   █   █ █   █ █ █   █ █ █     █ █ █ █   █   █ █ █   █   █         █ █ █         █ █   █
███ ███ ███ █ █████ █ █████████ █ █ ███ █ ███ █ █████ █ ███ █ █████ █████ ███████ █ ███ ███████████ █
█   █ █     █     █   █         █   █   █ █   █         █     █ █     █ █   █             █       █ █
█ █ █ █ █ █ █████ ███████ ███ █ ███ ███████ ███████ ███ █ █████ █ █████ ███ ███ █ █ █ █ ███ █ █████ █
█ █ █   █ █     █ █   █     █ █ █ █ █ █ █ █       █   █ █ █   █     █   █       █ █ █ █ █   █ █   █ █
█████ █████████ █ █ ███ █ █████ █ █ █ █ █ ███ ███ █████████ ███ ███ █ ███ █████████ ███████ ███ ███ █
█       █           █   █   █   █               █       █       █       █     █                    X█
█████████████████████████████████████████████████████████████████████████████████████████████████████
